aeration	"공기에 쐼, 환풍, 순환"
aerodynamic	공기역학의
aerobic	호기성의
alternate	"번갈아 일어나다, 교체하다, 번갈아 하는, 교대의"
ambidextrous	"양손잡이의, 솜씨가 비범한"
ambiguous	"모호한, 분명하지 않은"
amphibian	"양서류의, 양서동물"
amphibious	"양서류의, 수륙양용의"
archaeology	"유적, 유물, 고고학"
archaeopteryx	시조새
archetype	"원형, 전형"
astronomy	천문학
catastrophe	"대참사, 대재앙"
auditorium	"청중석, 강당"
autobiography	"자서전, 자전"
autocrat	"독재 군주, 독재자"
autograph	"서명, 사인을 해주다"
embargo	"출항 금지, 금지"
benediction	"축복, 감사기도"
benefactor	"은혜를 베푸는 사람, 기부자, 후원자"
beneficient	"자선심이 많은, 선행을 하는"
bibliography	서지학
accuse	"고발하다, 비난하다"
excuse	"변명, 사과, 구실, 변명하다, 용서하다"
caustic	"통렬한, 신랄한"
inexcusable	용서받을 수 없는
exceed	"넘다, 초과하다"
secede	탈퇴하다
antecendent	"앞서는, 선행의, 조상, 선조"
eccentric	"별난, 괴벽스러운"
centrifuge	원심 분리하다
ascertain	"확인하다, 규명하다"
certify	"증명하다, 인증하다"
claim	"요구하다, 주장하다, 요구, 주장"
proclaim	"선언하다, 공포하다"
disclaim	"~의 권리를 포기하다, 부인하다"
acclaim	"갈채, 환호, 갈채하다"
exclaim	"외치다, 감탄하다"
conclude	"끝내다, 결론짓다"
enclose	"에워싸다, 동봉하다, 넣다"
reclusive	"세상을 버린, 은둔한, 쓸쓸한"
accredit	"~으로 돌리다, 믿다, 인가하다"
creed	"신념, 신조 ,교의"
creditor	채권자
dictate	"구술하다, 받아쓰게 하다"
contradict	"부인하다, 모순되다"
dictator	"독재자, 지배자"
condone	"묵과하다, 용서하다, 속죄하다"
anecdote	"일화, 기담, 비화"
antidote	해독제
conduct	"행동하다, 지휘하다, 이끌어 내다, 행위, 행실, 지도"
induce	"야기하다, 권유하다"
faculty	"능력, 재능 ,기부, 학부"
genuine	"진짜의, 타고난, 진실된"
exaggerate	"과장하다, 과대시하다"
congestion	"밀집, 폭주, 혼잡"
heritage	유산
inherit	"상속하다, 물려받다"
heredity	"유전, 유전적 형질, 계승"
inherent	"물려받은, 상속 받은, 내재된"
humiliate	"굴욕감을 느끼게 하다, 창피를 주다"
object	"반대하다, 항의하다, 물건, 목적, 대상"
adjacent	"이웃의, 직전의"
judicial	"사법의, 재판의"
laborious	"힘이 드는, 근면한"
collaborate	"공동으로 일하다, 협력하다"
locomotion	"운동, 이동, 교통기관"
locality	"장소, 소재"
locus	"장소, 위치, 현장"
relocate	"다시 배치하다, 재배치하다"
maneuver	"책략, 술책, 작전, 조정하다"
manuscript	"원고, 손으로 쓴것"
manipulate	"교묘하게 다루다, 솜씨있게 처리하다"
meditate	"꾀하다, 명상하다, 숙고하다"
medieval	"중세의, 고풍의"
medium	"매개물, 수단, 방편"
intermediate	"중간의, 중간에 일어나는, 중급자"
migrate	이주하다
emigrate	"이주하다,전출하다"
immigrate	"이주하다, 전입하다"
emit	"방사하다, 내뿜다"
admit	"수용하다, 받아들이다"
omit	"생략하다, 빠뜨리다"
respect	"존경하다, 준수하다"
prospect	"전망, 가망, 기대, 기대되는"
suspect	"짐작하다, 의심을 두다"
speculate	"사색하다, 추측하다"
assimilate	"동화하다, 동화"
resemble	"~을 닮다, 공통점이 있다"
assemble	"모으다, 조립하다"
ascend	"오르다, 상승, 오름"
descend	"내려오다, 전해지다, 자손, 후예"
transcend	"초월하다, 능가하다, 선험적인, 막연한"
satiate	"충분히 만족시키다, 싫증나게 하다"
saturate	"흠뻑 적시다, 포화시키다"
unsaturated	"만족할 수 없는, 불포화의"
predescribe	"규정하다, 정하다, 처방하다"
subscribe	"서명하다, 정기 구독하다"
ascribe	"~에 돌리다, ~의 탓으로 돌리다"
inscribe	"새기다, 파다"
invert	"거꾸로 하다, 전도시키다"
adverse	"반대의, 적의의, 불리한"
divert	"유용하다, 전환시키다"
converse	이야기하다
abdicate	"버리다, 포기하다, 퇴위하다"
abolish	폐지하다 
animate	생기있게 하다
decorate	장식하다
demolish	"헐다, 철거하다, 파괴하다, 폐지하다"
elucidate	"설명하다, 해명하다, 밝히다"
fascinate	"매혹하다, 반하게 하다"
furnish	"공급하다, 제공하다, 갖추다"
imitate	"모방하다, 모사하다"
mediate	"중간에서 조정하다, 화해시키다"
neutralise	"중립화하다, 중화하다, 무효화하다"
nourish	"기르다, 자양분을 주다"
stabilise	"안정시키다, 고정시키다"
subsidise	"보조금을 지급하다, 도움을 얻다"
sweep	"청소하다, 쓸어내리다"
symbolise	"상징하다, 부호로 나타내다"
sympathise	"동정하다, 동감하다, 동의하다"
deal	"~와 관련을 맺다, 거래하다"
deepen	"깊게 하다, 심화시키다"
depict	"그리다, 묘사하다"
fasten	"묶다, 죄다, 닫히다"
glorify	"찬양하다, 영광스럽게하다, 미화하다"
harden	"굳게 하다, 경화시키다, 강하게 하다"
hearten	"기운나게 하다, 격려하다"
lengthen	"길게 하다, 연장하다, 늘어나다"
lessen	"적게하다, 작게하다, 줄이다"
nullify	"무효로 하다, 파기하다"
purify	"깨끗이 하다, 정화하다"
qualify	"자격을 얻다, 권한을 주다, 제한하다"
soften	"부드럽게 하다, 경감하다"
worsen	악화시키다
allegorical	"우화의, 우화적인, 우의적인"
awesome	"굉장한, 아주 멋진, 무시무시한"
capable	유능한
delicate	"섬세한, 고운 우아한, 깨지기 쉬운, 정밀한, 예민한"
dormant	"잠자는, 휴지상태에 있는, 잠재하는"
edible	"먹을 수 있는, 식용에 알맞은"
evergreen	"늘 푸른, 상록의"
favourable	"호의적인, 유리한"
generous	"관대한, 풍부한, 짙은"
identical	"동일한, 꼭 같은"
intellectual	"지적인, 이지적인"
meager	"메마른, 빈약한, 풍부하지 못한"
ubiquitous	"어디에나 있는, 편재하는"
versatile	"다재다능한, 다방면의, 다용도의"
abolition	"폐지, 노예제도 폐지"
additive	"첨가물, 첨가제"
admission	"입장, 승인"
adornment	"꾸미기, 장식"
ambition	"큰 뜻, 야심, 열망"
fibre	"섬유, 내구성"
fugitive	"도망자, 탈주자, 망명자"
hostage	"인질, 담보물"
nuptial	"결혼식, 혼례"
solitude	"독거, 고독, 쓸쓸한 곳"
worship	"예배, 숭배, 존경, 예배하다, 숭배하다"
youth	"젊은, 청년시절, 발육기"
abruptly	"갑자기, 뜻밖에"
arbitrarily	"임의로, 독단적으로, 제멋대로, 마음대로"
beneath	"밑에, 하위에, 낮은, 가치가 없는"
briefly	"간단히, 잠시 동안"
deadly	"몹시, 치명적으로, 치명적인 심한"
further	"더 멀리, 더 나아가서, 게다가, 뒤따른 진행시키다, 조성하다"
newly	"최근에, 새로이, 다시"
notably	"현저하게, 특히"
occasionally	"때때로, 이따금"
openly	"공공연하게, 솔직히"
partly	"부분적으로, 어느 정도는"
roughly	"거칠게, 대충"
ruthlessly	"무자비하게, 가차 없이, 냉혹하게"
seldom	"드물게, 좀처럼"
somewhat	"얼마간, 약간, 다소"
throughout	"도처에, 처음부터 끝까지"
virtually	"사실상, 실제적으로"
while	"~하는 동안, 동안, 잠깐, 잠시"
wholly	"전적으로, 완전히, 오로지"
dislike	"싫어하다, 좋아하지 않다"
disorder	"무질서, 혼란, 병, 질환"
inactive	"활동하지 않는, 나태한"
inadequate	"불충분한, 부적당한"
informal	"형식을 따지지않는, 비공식적인, 비공식, 약식"
insane	"제정신이 아닌, 미친, 어리석은"
immobile	"부동의, 움직일 수 없는"
impartial	"공평한, 편파적이 아닌"
irregular	"불규칙한, 고르지 못한"
misuse	"오용, 남용, 학대, 악용하다, 학대하다"
misfortune	"불운, 불행, 역경"
mitaken	"틀린, 오해한"
mishap	"사고, 재난, 불상사"
amoral	도덕적이지 않은
amorphous	"무정형의, 조직이 없는"
apathy	"냉담, 무관심"
atypical	"부정형의, 전형적이 아닌"
malfunction	"기기고장, 오작동"
malnutrition	"영양부족, 영양실조"
malignant	"악의적인, 해로운, 악성"
maltreatment	"학대, 혹사"
malevolent	"악의 있는, 남의 불행을 기뻐하는"
nonaggression	불가침
none	아무도-않다
antiwar	반전의
antifreeze	부동액
antiseptic	"방부제, 방부제의"
antipathy	"반감, 혐오"
antivenom	해독제
antisocial	비사교적인
antithesis	"대조, 정반대"
antarctic	남극의
antonym	반의어
antagonistic	"적대적인, 상반되는, 대립하는, 사이가 나쁜"
antacid	"산을 중화하는, 제산제"
anthelmintic	"구충제, 회충약, 구충의"
counteract	"거스르다, 방해하다, 중화하다, 좌절시키다"
counterattack	"역습, 반격"
counterpart	"상대, 사본"
counterbalance	"평형추, 평형력"
counterclockwise	"시계 반대 방향의, 시계 반대 방향으로"
contradiction	"부정, 모순"
contraceptive	피임용의
controversy	"논쟁, 말다툼, 언쟁"
objection	"반대, 이의"
obstruct	"막다, 차단하다, 방해하다"
obliterate	"지우다, 없애다, 말소하다"
obscene	"외설한, 음란한, 지겨운"
obnoxious	"불쾌한, 싫은, 비위 상하는"
oppose	"반대하다, 대항하다, 대치하다"
oppress	"압박하다, 억압하다, 박해하다"
ostentatious	"과시하는, 야한, 화려한"
withhold	"보류하다, 억제하다"
withstand	"저항하다, 버티다"
wither	"마르다, 시들다, 사라지다"
provoke	"불러일으키다, 야기하다, 화나게 하다"
propel	추진하다. 나아가게 하다.
prophet	"예언자, 선지자"
predominant	"우세한, 유력한, 탁월한, 지배적인"
foresee	"예견하다, 예치하다"
foretell	"예고하다, 예언하다"
forefather	"조상, 선조"
foremost	"일류의, 으뜸가는"
antique	"골동품, 미술품, 고미술의, 골동의"
ancestor	"조상, 선구자"
advance	"전진, 발전, 나아가다, 제출하다,승진시키다"
recede	"물러가다, 감소하다, 떨어지다"
revoke	취소하다
recant	"고치다, 취소하다, 부인하다"
restrospect	"회상, 회고, 추억"
retrograde	"후퇴하는, 역행하는, 되돌아가는"
retroact	"이전으로 소급하다, 거꾸로 작용하다"
retrocede	"반환하다, 되돌아가다, 물러가다, 후퇴하다"
retroactive	"소급하는, 반동하는"
postgraduate	대학원생
postpone	"뒤로 미루다, 연기하다"
postimpressionist	후기인상파 화가
postscript	"후기, 추신, 해설"
afterward	"후에, 나중에, 그 후에"
afterword	"맺는말, 발문, 후기"
afterlife	"내세, 사후의 삶"
superior	"뛰어난, 우수한, 상위의, 우월, 탁월"
supervise	"감독하다, 관리하다, 지휘하다"
supreme	"최고의, 최상의 최우수의"
superstition	"미신, 우상, 공포"
supernatural	"초자연의, 신비적인, 불가사의한"
surface	"표면, 평면, 외부, 겉보기, 외관, 떠오르다"
surpass	"능가하다, 초월하다, -보다낫다"
surplus	"나머지, 잉여(금)"
surrender	"넘겨주다, 포기하다, 항복하다"
oversee	"감독하다, 두루살피다, 망보다"
overcome	"이기다, 패배시키다, 압도하다, 압도하는, 패배시키는"
overturn	"전복시키다, 뒤집다, 넘어뜨리다"
overlook	"내려다보다, 대충 보다, 못보고 지나치다"
overpower	"이기다, 눌러버리다, 제압하다"
upright	"똑바로 선, 직립의, 올바른, 강직한"
uproot	"뿌리뽑다, 몰아내다, 근절하다"
upstream	"상류에, 강을 거슬러 올라가서, 상류의, 흐름을 거슬러 오르는"
upheaval	"격변, 대변동"
undertake	"착수하다, 시작하다, 액동하다, 동의하다"
undergo	"만나다, 당하다, 겪다, 경험하다, 견디다, 참다"
underlying	"근원적인, 잠재적인"
undergraduate	"대학생, 학부생"
undercurrent	"저의, 부정적 감정, 암류"
submarine	"해저의, 바닷속의, 잠수함의, 잠수함"
submerged	"수몰된, 액체 내에서, 물속에서 자라는, 감추어진"
subscription	"기부, 예약구독, 신청"
substantial	"상당한, 실질적인, 중요한"
suspend	"매달다, 중지하다"
suppress	"억압하다, 가라앉히다"
sustain	"견디다, 유지하다"
downwind	"바람이 불어가는 쪽으로, 순풍의"
downhill	"내리막길, 몰락"
donwstream	"하류의, 강 아래로, 하류에, 강 아래로"
downfall	"낙하, 쏟아짐, 몰락"
influx	"유입, 밀어닥침"
inhale	"들이마시다, 흡입하다"
imprision	"교도소에 넣다, 수감하다"
interior	"내부, 인테리어, 안의, 내부의"
interfere	"방해하다, 충돌하다, 간섭하다"
endemic	풍토병의 지방 특산의
enact	"제정하다, 규정하다"
enslave	"노예로 만들다, 사로잡다"
endanger	"위태롭게하다, 위험에 빠트리다"
endotoxin	내독소
eject	"쫓아내다, 추방하다, 뿜어내다"
emigration	"이민, 이주"
ecstasy	"무아경, 황홀경, 정신 혼미"
external	"외국의, 대외적인"
exterior	"외부, 외부의, 밖의, 대외적인"
extraordinary	"비상한, 비범한, 훌륭한, 특별한"
extravagant	"낭비하는, 사치스러운 기발한, 엄청난, 지나친"
outlaw	"추방하다, 불법화하다, 금지하다, 무법자, 불량배, 반역자, 추방자"
outbreak	"발발, 돌발, 급증, 폭동"
outdo	"능가하다, -보다낫다, 이기다"
abduct	"유괴하다, 납치하다, "
abnormal	"이상한, 변칙의"
abstain	"삼가다, 절제하다"
abhor	"몹시 싫어하다, 혐오하다, 증오하다"
avert	"돌리다, 외면하다, 피하다"
degrade	"퇴화시키다, 좌천시키다"
decompose	"분해하다, 부패시키다, 분석하다"
depart	"떠나다, 벗어나다, 출발하다"
diagnosis	"진단, 식별"
dialect	"방언, 지방사투리"
transatlantic	"대서양 건너편의, 대서양 횡단의, 미국인"
transplant	"이식, 이주, 식물을 옮겨 심다, 이식하다, 이주시키다"
seclusion	"격리, 은둔"
sedue	"부추기다, 유혹하다"
segregate	"분리하다, 격리하다"
cataclysm	"대재앙, 대변동"
cataract	"큰 폭포, 홍수, 백내장"
catabolism	"이화작용, 분해 대사"
catapult	"투석기, 장난감 새총"
compact	"정식 동의, 협정, 조밀한, 채우다, 압축하다"
compose	"조립하다, 구성하다, 만들다, 작곡하다"
corrput	"타락한, 부패한, 타락시키다"
sympathy	"공감, 동정심, 연민"
symmetry	"대칭, 균형, 조화"
synchronise	"동시에 일어나다, 시간을 맞추다"
accustom	"익숙하게 하다, 익히다"
affirm	"단언하다, 주장하다"
opportune	"적절한, 시기가 좋은, 알맞은"
appease	"달래다, 진정시키다, 충족시키다"
ashore	"물가에, 해벽에"
enrich	"풍성하게 하다, 부유하게 하다"
enliven	"생기를 주다, 활기 있게 만들다"
amaze	깜짝 놀라게 하다
perfume	"향수, 향기"
semicircle	"반원, 반원형"
semipermeable	반투성의
semiconductor	반도체
hemisphere	"반구, 반구체, 범위, 영역"
semifinal	"준결승, 준결승의"
uniform	"한결같은, 균일한, 유니폼, 제복"
union	"연합, 결합, 노동조합"
unification	"통일, 단일화, 통합"
monarchy	"군주정치, 군주제"
monologue	"독백, 혼자만의 이야기"
monomer	"단량체, 모노머"
monotonous	"단조로운, 지루한"
biannual	일년에 두 번씩
dichotomy	"이분법, 양분"
bilingual	"2개 국어를 하는, 이중언어의"
twin	쌍둥이
trigonometry	"삼각법, 삼각술"
tripod	"삼각대, 세 개의 다리"
quarter	"4분의 1, 4분기, 15분"
pentagon	5각형
octave	"옥타브, 음정"
octopus	낙지
heptathon	7종 경기(육상)
hexapod	"6각류, 곤충, 다리가 6개 있는"
decimal	"십진법의, 소수의"
centrigrade	"백분도, 섭씨 온도, 섭씨의"
hectare	헥타르(1만 평방미터)
multipurpose	"다목적의, 여러 목적에 쓰이는"
multicellular	다세포의
polythesim	"다신론, 다신교"
polymer	"중합체, 고분자"
eulogy	"찬미, 찬송, 찬양"
euphemism	완곡어법
well-balanced	"균형 잡힌, 제정신의, 온건한"
well-known	"유명한, 잘 알려진, 친밀한"
circumvent	"일주하다, 우회하다, 피하다"
circumference	"원주, 주변, 경계선"
circumscribe	"~의 둘레에 선을 긋다, 제한하다, 억제하다"
circumspect	"조심성 있는, 신중한"
hyperbole	과장
hyperactive	"활동 과잉의, 매우 활동적인"
hypertension	고혈합
hypothesis	"사설, 가정"
hypocrite	위선자
interpersonal	"인간 사이에 존재하는, 대인 관계의"
interplanetary	행성 간의
intravenous	"정맥 내의, 정맥주사의"
intramuscular	근육 내의
metamorphic	"변화의, 변태의"
metabolism	"물질 대사, 신진대사"
parasites	기생충
parallel	"평행의, 같은 방향의"
paralysis	"마비, 무력, 무능"
homogenous	"역사적 상동의, 균질의"
homosexual	"동성애, 동성애자"
heterozygous	"이협접합체의, 이형의, 잡종성의"
homologous	"상동의, 일치하는"
homology	"상동 관계, 상동"
macromolecular	거대 분자의
microcosm	소우주
microbiology	미생물학
perimeter	"주변, 경계선, 방어선"
neolithic	신석기시대의
abuse	"남용, 학대, 욕설"
appreciate	"감상하다, 인식하다, 고맙게 생각하다"
attribute	"~의 결과로 보다, 속성, 특성"
capital	"수도, 자본 대문자"
cast	"던지다, 주조하다, 배정하다"
charge	"청구하다, 고발하다, 요금"
due	"지불 기일이 된, 정당한, 당연한 권리, 부과금"
even	"한층, 더욱, 오히려, 평탄한, 한결같은, 짝수의"
express	"표현하다, 나타내다, 급행의"
foul	"더러운, 부정한, 충돌한"
settle	"정착하다, 해결하다, 결정하다"
state	"상태, 사정, 정부, 진술하다, 국가의, 주립의"
steep	"가파른, 험주한, 터무니없는, 적시다, 열중하다, 가파름, 험준함"
subject	"주제, 학과, ~의 영향을 받기 쉬운, 복종시키다"
suit	"적응시키다, 어울리다, 슈트, 소송"
tap	"가볍게 두드림, 꼭지, 개발하다"
term	"학기, 전문어, 조건, 협약, 동의, 이름 짓다"
treat	"간주하다, 대우하다, 치료하다, 치료"
wonder	"궁금하다, 경탄할 만한 것"
account for	"~을 설명하다, 차지하다"
at the mercy of	~에 좌우되어
attribute A to B	A를 B의 탓으로 돌리다
be prone to	~하기 쉽다
bear in mind	~을 명심하다
behind the times	시대에 뒤떨어진
bring about	"~을 유발하다, 초래하다"
bring home to	~에게 절실히 느끼게 하다
carry out	"~을 수행하다, 완수하다"
come up with	"~을 찾아내다, 생산하다, 제시하다"
consist of	"~로 구성되다, 이루어지다"
cut a fine figure	두각을 나태나다
devote oneself to	~에 몰두하다
distinguish oneself	"이름을 내다, 공을 세우다"
divide into	~으로 나누다
do away with	"~을 제거하다, 죽이다"
find fault with	~을 비난하다
for the sake of	~을 위하여
in addition to	"~에 대하여, 이외에"
in behalf of	"~을 위하여, ~을 도우려고"
in the presence of	"~의 면전에서, ~의 앞에서"
in virtue of	"~의 덕분에, ~에 의하여"
keep pace with	~과 보조를 맞추다
keep track of	"~을 기록하다, 추적하다"
lag behind	"~보다 뒤쳐지다, ~보다 뒤떨어지다"
make allowances for	"~을 참작하다, 감안하다"
make good	"성공하다, 보상하다, 수리하다"
prior to	"~에 앞서, 먼저"
set forth	"~을 설명하다, 출발하다"
stand for 	"~을 나타내다, 상징하다, 대표하다"
take into account	"~을 고려하다, 참작하다"
take it for granted	"~을 당연한 일로 생각하다, 당연히 ~일 거라고 믿다"
take up	~을 흡수하다
turn into	"~로 변하다, 바뀌다"
up to	"~에 이르기까지, ~까지"
wear out	"~을 다 써버리다, 닳아 얿어지게 하다"
colony	"집단, 군체, 콜로니, 서식지"
zoology	동물학
fauna and flora	"동식물군, 동식물종"
mammal	포유동물
carnivorous	육싱성의
predator	포식자
primate	영장류
invertbrate	무척추동물
hibernation	동면
offspring	"자식, 생겨난것"
domesticate	"길들이다, 교화하다"
camouflage	"위장, 눈가림, 위장하다"
nest	"보금자리, 둥지, 굴"
dominant	"지배적인, 두드러진"
trail	"끌다, 추적하다, 지나간 자국, 흔적"
dwell	"살다, 거주하다"
fertilise	"수정하다, 비옥하게 하다"
pollen	"화분, 꽃가루"
bud	"눈, 미숙한 것, 싹트다, 자라기 시작하다"
trunk	코끼리 ㅋ
shrub	관목
blosoom	"꽃, 개화하다"
reproduce	"복제하다, 번식하다"
swarm	"무리를 이루다, 떼를 짓다, 무리"
kindgom	"(생물)계, 영토, 왕국"
evolutionary theory	진화론
variety	"종류, 다양성, 여러가지"
homogenise	"균질이 되게 하다, 통일하다"
liberal arts	인문학
humanism	인도주의
linguistics	언어학
wit	"지혜, 가치, 재치"
intonation	"억양, 어조"
emphatic	"어조가 강한, 단호한, 강조하는"
prefix	접두사
decipher	"해석하다, 판독하다"
phonetic	"발음대로의, 음성의"
phonics	"발음 중심의 언어학 지도법, 음향학"
syllable	음절
coinage	화폐제도
abridge	"요약하다, 줄이다, 약화시키다"
satire	"풍자, 비꼼"
criticism	"비평, 비판"
fable	"우화, 꾸며낸 이야기"
renaissance	문예부흥
regard	"~으로 여기다, 보다, 존경, 관계, 고려, 주시"
starve	"굶주리다, 갈망하다"
sense	"감각, 의식, 분별 의미"
contemporary	"같은 시대의, 현대의, 동시에 발생한"
colloquial	"구어체의, 일상 회화의"
discipline	"학과, 훈련, 징계"
compulsory	"강제적인, 필수의"
elective	"임의의 선택의, 선거에 의한"
obligatory	"의무적인, 필수의"
extracurricular	"과외의, 정규과목 이외의"
underscore	강조하다
enroll	"입학시키다, 등록하다"
examination	시험
scholarship	"장학금, 학문"
dissertation	학위논문
diploma	"졸업장, (대학)과정"
graduate	"졸업, 대학원 학생, 졸업하다, 학위를 수여하다"
forbid	"금하다, 허락하지 않다"
confer	"협의하다, 수여하다"
inform	"알리다, 통지하다"
rely	"의지하다, 신뢰하다"
audiovisual	시청각의
literacy	읽고 쓸 줄 아는 능력
further education	성인교육
distance learning	"통신교육, 방송교육, 원격교육"
deam	"학장, 학생과장, 주임 사제"
acidic	"산의, 신맛이 나는, 신랄한"
derivative	"유도체, 파생어, 새롭지 않은"
acting	"직무 대행의, 연출용의, 작용하는"
adhesive	"접착제, 점착성이 있는 것, 점착성의, 끈끈한"
synthetic	합성의
isotope	동위원소
alchemy	연금술
vacuum	진공
dense	"밀집한, 빽빽한"
evaporate	증발하다
equilibrium	"평형, 균형"
soak	"적시다, 빨아들이다"
ignite	"불을 붙이다, 발화시키다"
shift	"방향을 바꾸다, 물건을 이동시키다, 변화, 교체, 수단"
erode	"침식하다, 부식시키다"
adhere	"들러붙다, 고수하다"
sphere	"구체, 천체, 하늘, 영역"
abandon	"그만두다, 버리다, 포기하다"
address	"말을 걸다, 연설하다, 주소를 쓰다, 연설, 주소"
admire	"감탄하다, 경애하다, 칭찬하다"
sail	"출항하다, 조종하다"
exile	"추방하다, 유배에 처하다"
marriage	"결혼, 혼인"
pheonomenon	"현상, 사건"
conventional	"전통적인, 관습적인"
clan	"씨족, 일문"
extended family	대가족
socialism	사회주의
expenditure	"지출, 경비, 소모"
fluctuate	"변동하다, 오르내리다"
fiscal	"국고의, 재정상의, 회계의"
merchandise	"상품, 거래하다"
commerce	"상업, 교역"
bankruptcy	"파산, 실패"
commission	"위원회, 임무, 수수료"
depression	"의기소침, 불경기, 우울증"
transaction	"처리 ,거래, 매매"
holding	"보유, 쥠, 소유권, 들고 있는"
annual consumption	연간 소비량
audit	"회계감사를 하다, 심사하다, 청강하다, 회계감사"
masterpiece	"걸작, 대표작"
impressionism	인상파
pigment	"안료, 색소"
eloquent	"웅변을 잘하는, 유창한"
easel	"이젤, 받침틀"
lullaby	자장가
pitch	"음조, 투구, 경기장, 내던지다"
civic	"시민의, 도시의"
compete	"경쟁하다, 경합하다, 필적하다"
bill	"계산서, 지폐, 법안, 청구서를 보내다, 알리다"
constitute	"구성하다, 설립하다"
ratification	"비준, 추인"
legitimate	"합법적인, 합리적인"
legislation	"법률제정, 법안"
jurisprudence	"법률학, 법리학"
enforce	"실시하다, 집행하다"
court	"법정, 구애하다, 사귀다"
decree	"법령, 판결"
tariff	"관세, 요금표"
arbitrate	"중재하다, 조정하다"
solicitation	"간청, 권유, 교사죄"
attorney	"대리인, 변호사, 검찰총장"
hearing	"청력, 듣기, 공청회"
trial	"공판, 심리, 실험, 시도"
administer	"관리하다, 다스리다"
testify	"증명하다, 증언하다"
amend	"고치다, 개정하다"
saddle	"안장을 얹다, 책임을 지우다, 안장"
sue	"고소하다, 소송을 제기하다"
lawsuit	"소송, 고소"
perjury	위증죄
criminal	"범죄자, 범죄의, 형사상의"
verdict	"평결, 답신"
smuggle	밀수하다
misdemeanor	"경범죄, 못된 짓"
breakthrough	"돌파구, 큰 발전"
optical	"눈의, 빛의, 광학상의"
alteration	"변경, 개조, 변화"
property	"재산, 소유, 부동산, 특성, 소유"
access	"이용하다, 접근하다, 접근"
arc	"호, 원호"
arithmetic	"산수, 연산"
reckon	"세다, 계산하다, 측정하다, ~라고 생각하다"
sector	"부문, 부채꼴"
spherical	"구형의, 둥근, 천체의"
convex	볼록한
perpendicular	"직각을 이루는, 수직선"
aggravate	"악화시키다, 짜증나게 하다"
anatomy	"해부학, 구조, 몸"
disinfect	"살균 소독하다, 바이러스를 제거하다"
influenza	독감
prescription	"처방, 규정, 법규"
limb	"다리, 팔, 날개, 돌출부"
quarantine	"검역, 격리"
chronic	"상습적인, 만성적인"
contagious	전염성의
contamination	"오염, 타락"
vector	"매개자, 벡터, 진로"
decaying	"썩어 가는, 부패하는, 쇠퇴하는"
therapeutic agent	치료제
germ	"세균, 병원균, 새싹, 기원"
circulatory system	순환계
cleaning agent	"청소 약품, 표백제"
foot-and-mouth disease	구제역(가축의 입과 발굽에 생기는 전염병)
spoil	"망치다, 썩히다"
obese	지나치게 살찐
biosafety	생물 안전
sickness	"병, 메스꺼움"
portrayal	"그리기, 묘사, 연기"
anthropology	인류학
silt	"미사, 가는 모래, 막다, 흐르다"
airlift	공수 물자(인원)
unpopular	"인기 없는, 유행하지 않는"
chancellor	"장관, 대법관, 수상"
lifesaver	"수영장 감시원, 인명구조원"
batch	"한 솥, 한 화분, 일괄 묶음"
surge	"치밀어 오름, 급증, 파도처럼 밀려오다"
splendour	"훌륭함, 빛남"
tyrant	"폭군, 전제"
benign	"온화한, 정다운, 친절한"
cottage	"시골집, 작은 집"
profound	"깊은, 심오한, 난해한"
suffocate	"숨을 막다, 질식사하다"
engaged	"약속된, 약혼한, ~에 종사하는"
unusual	"보통이 아닌, 비범한"
clamp	"죄다, 고정시키다, 걸쇠, 집게"
topography	"지형학, 지형도"
cliff	"낭떠러지, 절벽"
altruism	"이타주의, 이타적 행위"
inconspicuous	"눈에 띄지 않는, 뚜렷하지 않은"
epic	"서사시, 서사시적 작품"
cozy	"기분 좋은, 편안한, 아늑한"
decent	"괜찮은, 제대로 된, 품위 있는"
flattery	"아첨, 감언"
companionship	"교우, 교제"
conservation	"보존, 보호"
burial	"매장, 토장"
sentiment	"감정, 감상"
endosymbiosis	내부 공생
stump	그루터기
suck	"빨다, 빨아 먹다(마시다)"
unanimous	"합의의, 만장일치의"
confuse	"혼동하다, 어리둥절하게"
emergence	"출현, 발생, 개화"
manifest	"명백한, 분명히 나타난"
meditation	"명상, 심사숙고"
auditory	"귀의, 청각의"
charter	"헌장, 선언문, 인가서"
mischievous	"짓궂은, 장난이 심한, 개국쟁이의"
death toll	"(사고, 전쟁 등의) 사망자 수"
emancipate	"해방시키다, 석방하다"
underneath	"~의 아래에, 밑면에"
confidential	"기밀의, 비밀의"
thesis	"논문, 작물"
obstruction	"방해물, 장애물"
lay egg	알을 낳다
ardent	"불타는 듯한, 열렬한"
maritime	"바다의, 해양의, 해안의"
tactics	"전략, 작전(행동)"
captivity	"감금, 억류"
depot	"창고, 보급소"
rehabilitate	"원상으로 복구하다, 부흥하다"
upturn	"위로 향하게 하다, 파헤치다, 전복, 상승"
transcript	"사본, 복사, 녹취록"
complexion	"안색, 외관"
booth	"노점, 매점, 칸막이 좌석"
allegiance	"충성, 출정, 충직"
perspective	"원근법, 전망, 견해, 관점"
pledge	"맹세, 약속, 담보, 보증, 맹세하다"
elongate	"연장하다, 늘이다"
distress	"괴롭히다, 슬프게 하다, 곤란, 괴롭힘"
chamber	"방, 회의실"
disapprove	"안 된다고 하다, 찬성하지 않다"
succint	"간결한, 간단 명료한"
lifelong education	평생교육
behalf	"이익, 원조, 지지"
vice	"악덕, 부도덕, 결함"
dispose	"배치하다, 처리하다"
unpleasant	"불쾌한, 재미없는"
auxiliary	"보조의, 대용의"
loom	"어렴풋이 나타나다, 불안하게 다가오다, 베틀, 직기"
blur	"흐리게 하다, 무감각하게 하다, 흐릿한 형체"
scholastic	"학생, 학자, 학교의, 학자의"
agile	"민첩한, 재빠른"
arboretum	"수목원, 식물원"
anti-abortion	임신중절에 반대하는
eternal	"영원한, 끝없는"
predacious	육식하는
distortion	"왜곡, 찌그러짐"
reluctant	"마음 내키지 않은, 달갑지 않은"
groom	신랑
banish	"추방하다, 내쫓다"
drawback	"약점, 결점, 장애"
latent	"숨어 있는, 보이지 않는, 잠재적인"
irrelevant	"엉뚱한, 부적절한, 관련이 없는"
destined	"예정된, 운명 지어진"
speck	"작은 얼룩, 작은 반점, 흠, 멍"
beforehand	"미리, 벌써"
celebrated	"유명한, 저명한"
secretion	분비(물)
sheen	"광택, 광휘, 현란한 의상"
evasive	"회피적인, 파악하기 어려운, 애매한"
inaccurate	"부정확한, 정밀하지 않은"
garment	"의복, 옷"
glossary	"소사전, 용어집, 어휘사전"
intermittent	"때때로 중단되는, 간헐적인"
degenerate	"퇴보하다, 타락하다"
intricate	"얽힌, 복잡한 "
municipal	"도시의, 좁은 범위 내에"
inaugurate	"취임시키다, 개시하다"
beating	"때림, 채찍질"
ratify	"비준하다, 재가하다"
ration	"배급량, 할당량, 배급하다"
vicious	"나쁜, 악덕의, 악의 있는"
puberty	사춘기
bosom	"가슴, 내심, 내부, 절친한, 사랑하는"
hesitate	"주저하다, 꺼리다"
brand-new	"신상품의, 아주 새로운"
defective	"결점이 있는, 불안전한"
turnover	"전복, 전도"
complication	"복잡, 귀찮은 문제"
petition	"탄원, 청원, 변명, 호소, 탄원하다, 신청하다"
tentative	"시험적인, 임시의, 모호한"
preliminary	"예비적인, 서문의, 시초의, 사전준비, 서문, 예비시험"
uncompromising	"타협하지 않는, 완고한"
considerable	"상당한, 적지 않은, 중요한"
inexpensive	"비용이 들지 않는, 비싸지 않은"
bribe	"매수하다, 뇌물을 주다, 뇌물"
consecutive	"연속하는, 계속적인"
coma	"혼수상태, 코마"
vibrate	"판단, 평가, 평가치"
paranormal	과학적으로 설명할 수 없는
baffle	"당황하게 하다, 좌절시키다"
allied	"연합한, 유사한"
reckless	"앞뒤를 가리지 않는, 무모한, 무모하게"
stimulating	"자극하는, 격려하는"
bee venom	"봉독, 벌침 독"
morality	"도덕, 덕행, 교훈"
consequence	"결과, 귀결, 중대함"
endorse	"배서하다, 보증하다"
weary	"피곤한, 싫증이 난, 따분한"
lease	"임대하다, 임대차, 임차권"
phase	"상, 면, 단계, 측면"
gallant	"용감한, 씩씩한, 친절한"
soaked	"흠뻑 젖은, 흠뻑 배인"
fascinating	"매혹적인, 반하게 만드는"
innocuous	"악의 없는, 무해한, 순진한"
gigantic	거대한
proliferate	"급증하다, 번식하다, 확산되다"
blaze	"화염, 불꽃, 격발, 타오르다"
dedicated	"일생을 바친, 헌신적인"
inferior	"하위의, 열등한"
cruise	"순항, 순항하다"
nucleus	"핵심, 세포 핵, 응결 핵"
planetary	행성의
chewing	"씹는, 깨무는, 저작"
sanitary	"위생의, 위생적인, 청결한"
solidarity	"결속, 단결, 연대, 자유노조"
current affairs	시사
annihilate	"전멸시키다, 무력하게 하다"
pictorial	"그림의, 그림으로 나타낸"
tenant	"세든 사람, 임차인"
wavy	"요동하는, 물결 모양의, 파도치는"
flight attendant	객실 승무원
efficiency	"능력, 능률, 효율"
piety	"경건, 신앙심"
uproarious	"떠드는, 법석 떠는, 시끄러운"
hand down	"~을 전하다, (후세에) 남기다"
lurk	"숨다, 잠복하다, 살금살금 거다, 잠복, 계략"
extensively	"널리, 광범위하게"
curve	"곡선, 곡면, 굴곡"
moth	(유충) 나방
reward	"보수, 사례금, 보상, 보답하다"
vanish	"갑자기 사라지다, 없어지다"
declaration	"선언, 포고, 신고"
termite	흰개미
perennial	"사철을 통한, 영구적인"
quota	"몫, 분담액"
esteem	"존중, 존경, 존중하다, 생각하다"
mutate	"변화하다, 돌연변이하다"
penetrate	"꿰뚫다, 관통하다, 침입하다"
barefoot	"맨발의, 맨발로"
improper	부적당한
epoch	"신기원, 신세대"
erroneous	"잘못된, 틀린, 정도를 벗어난"
emission	"방사, 발산, 방출, 배출물"
intimate	"친밀한, 친숙한, 상세한"
sickle	"낫, 낫 모양의 별무리, ~을 낫으로 베다"
surveillance	"감시, 감독"
viscous	"찐득찐득한, 점성의"
counselor	"상담역, 고문"
ample	"충분한, 풍부한, 넓은"
slaughter	"도살, 살육, 도살하다"
virus	"바이러스, 병독, 병원체"
drown	"익사시키다, 침수시키다"
unpredictable	예언 (예측)할 수 없는
cheif executive	"대통령, 주지사, 최고 지도자"
seperately	"따로따로, 개별적으로, 단독으로"
valuable	"금전적 가치가 있는, 값비싼, 귀중한"
rift	"금, 균열, 갈라지다, 찢다"
veil	베일로 가리다
disperse	"흩뜨리다, 해산시키다"
capital punishment	사형
frustrate	"실망시키다, 좌절시키다, 방해하다"
subsequent	"다음의, 수반하는"
retreat	"퇴각, 후퇴, 은퇴, 후퇴하다, 물러가다"
ranch	"대목장, 농장"
skim	"스쳐 가다, 대충 일가"
summit	"정상, 최고점, 정상회담"
absurd	"덜다, 완화하다"
ambassador	"대사, 특사"
unrest	"불안, 근심"
city council	시 의회
toast	"굽다, 불을 쬐다, 건배하다, 축배하다"
repress	"억제하다, 진압하다"
brittle	"부서지기 쉬운, 상처 입기 쉬운, 냉담한"
confined	"갇힌, 외출이 금지된"
stew	"끓이다, 애타게 하다, 스튜"
dye	"염료, 물감, 물들이다, 염색하다"
landfill	"매립식 쓰레기 처리, 매립지"
impeach	"탄핵하다, 비난핟"
terrain	"지역, 지대, 범위"
noxious	"유해한, 불건전한"
alluvial	"충적의, 충적토"
anathema	"저주, 파문"
mediocre	"보통의, 평범한, 이류의"
devout	"믿음이 깊은, 독실한"
reprimand	"꾸짖다, 질책하다, 징계, 비난"
circadian rhythm	24시간 주기 리듬
embezzlement	"도용, 횡령, 착복"
eclipse	"일식, 월식"
eligible	"적격의, 적임의, 바람직한, 적임자, 유자격자"
spine	"등뼈, 바늘, 가시 모양 돌기"
residue	"잔여, 잔류물, 잔여유산"
lucrative	"유리한, 돈이 벌리는"
siege	"포위 공격, 공성, 포위하다"
reservoir	"저수지, 급수소"
stiff	"뻣뻣한, 경직된, 강한, 팽팽한"
rebellion	"모란, 폭동"
outstrip	"앞서다, 뛰어나다, 초과하다"
plagiarise	표절하다
reverent	"숭상하는, 경건한"
sniff	"코를 킁킁거리다, 냄새를 맡다"
inheritance	"상속재산, 유산"
colossal	"거대한, 엄청난, 놀랄 만한"
corridor	"복도, 회랑"
glittering	"반짝이는, 빛나는, 화련한"
deterimental	"해로운, 불리한"
correspondent	"대응하는, 일치하는, 통신인, 특파원"
convection	"전달, 운반"
indcit	"기소하다, 고발하다"
distract	"흐트러뜨리다, 전환시키다"
levy	"장수하다, 부과하다, 압류하다, 부과, 징세, 소집"
setback	"좌절, 역류, 실패"
vernacular	"제 나라말, 자국어, 자국의"
forregone conclusion	"처음부터 알고 있는 결론, 뻔한 결과(필연적인 결론)"
ransom	"몸값, 배상금, 몸값을 지불하다"
sluggish	"불경기의, 느린, 게으름을 피우는"
tyranny	"전제정치, 학정, 횡포"
appal	"오싹하게 하다, 질리게 하다"
mutton	양고기
wean	"젖을 떼다, 이유시키다, 유아, 어린애"
topsoil	"표토, 겉흙"
wicked	"사악한, 심술궂은, 불쾌한"
majestic	"위엄 있는, 장중한"
varnish	"바니시, 광택제, 윤, 니스를 칠하다"
rehabilitation	"사회 복귀, 부흥, 재건"
brink	"가장자리, 물가, 직전"
perch	"앉다, 자리 잡다, 횃대"
tortoiseshell	"귀값, 거북이 등껍질, 별갑제의"
breeze	"산들바람, 미풍, 쉬운 일, 산들바람이 불다"
odometer	주행기록계
ravage	"유린하다, 파괴하다, 약탈하다, 파괴"
token	"표, 증거, 기념품"
shabby	"초라한, 낡아 빠진"
annotated	주석이 달린
toil	"수고하다, 고생하다, 노고, 수고"
mare	"암말, 암당나귀"
boredom	"지루함, 권태, 지루한 일"
litter	"어질러진 물건, 난잡, 쓰레기, 어질러 놓다, 흩뜨리다"
wade	"걸어서 건너다, 힘들여 나아가다"
dazzling	"눈부신, 현혹적인"
brisk	"활발한, 번창하는"
treason	"반역죄, 배신"
rugged	"울퉁불퉁한, 고된, 험악한"
reign	"치세, 왕대, 통치, 군림하다, 지배하다"
escort	"호송, 호위, 호위하다"
disloyal	"불충한, 불성실한, 신의 없는"
unequalled	"타의 추종을 불허하는, 같지 않은, 고르지 못한"
turmoil	"소란, 소동, 혼란"
indiscriminate	"무차별의, 난잡한"
vanity	"허영심, 허무함"
coffin	"관, 널, 판"
falter	"비틀거리다, 말을 더듬다, 주춤하다, 약해지다"
suffrage	"투표, 선거권"
skirmish	"작은 접전, 사소한 충돌"
ambush	"매복하다, 매복 습격하다, 매복, 잠복"
flunk	"실패하다, 단념하다, 낙제하다"
barrage	"연발 사격, 집중포화, 댐"
salvage	"해난 구조, 구출"
torrential	"맹렬한, 격한, 급류의"
salute	"경례하다, 인사하다, 거수 경례, 인사"
snare	"덫, 올가미, 함정, 함정에 빠뜨리다"
strenuous	"분투적인, 격렬한, 활발한"
lash	"후려치다, 몰아치다, 흔들다, 채찍질"
venomous	"독이 있는, 해로운, 악의에 찬, 원한을 품은"
wretched	"비참한, 불행한, 서툰, 야비한"
detatin	"못 가게 붙들다, 기다리게 하다, 유치하다"
stalk	"몰래 접근하다, 가만히 뒤를 밟다"
anthem	"노래, 성가, 찬송가"
exclusive	"배타적인, 독점적인, 제외하고"
implement	"권한을 주다, 실행하다, 충족시키다, 도구, 수단"
hectic	"소모성의, 열광적인, 몹시 바쁜ㄹ"
imbibe	"흡수하다, 섭취하다, 마시다"
pavement	"포장도로, 포장"
siesta	낮잠
impoverished	"가난하게 된, 허약해진, 불모의"
serene	"고요한, 평화스러운, 화창한"
rapport	"관계, 접촉"
vulnerable	"상처 입기 쉬운, 넘어가기 쉬운"
breeder	"번식하는 동식물, 양육자, 고속 증식로"
slippery	"미끄러운, 잘 빠져나가는"
repellent	"불쾌한, 혐오감을 주는, 기피하는, 기피제"
mesolithic	중석기 시대의
abate	"감소시키다, 누그러뜨리다"
affluent	"풍부한, 부유한"
indifference	"무관심, 냉담, 중요치 않음"
entail	"남기다, 수반하다, 부과하다"
entangle	"뒤얽히게 하다, 혼란시키다, 빠뜨리다"
imminent	"임박한, 절박한"
impair	"감하다, 손상시키다, 해치다"
habitual	"습관적인, 규칙적인, 상습법, 알코올 중독자"
unleash	"~의 가죽 끈을 풀다, 해방하다, 자유롭게 하다"
explicit	"분명한, 명백한, 숨김없는"
imperative	"명령적인, 단호한, 피할 수 없는, 긴급한, 긴요한"
enthusiastically	"열광적으로, 열중하여"
evade	"피하다, 회피하다"
exalt	"높이다, 승진시키다, 찬양하다"
imperceptible	"눈에 보이지 않는, 지각할 수 없는, 미세한"
ferocious	"사나운, 맹렬한, 잔인한"
superb	"최고의, 뛰어난, 화려한"
ethereal	"미묘한, 공기 같은, 가벼운, 하늘의"
evacuate	"비우다, 철수시키다, 피난하다"
impregnable	"난공불락의, (신념이) 흔들리지 않는"
snarl	"얽히다, 혼란스럽게 되다, 으르렁거리다, 호통 치다"
incompatible	"~와 맞지 않는, 양립할 수 없는"
excavate	"파다, 발굴하다"
exclamation	"외침, 절규, 감탄, 감탄사"
exorbitant	"과도한, 사치하는"
expertise	"전문 기술, 전문가의 감정서"
sprawl	"팔다리를 펴다, 꿈틀거리다, 불규칙하게 넓어짐"
exterminate	"파괴하다, 전멸시키다, 근절하다"
fierce	"사나운, 잔인한, 격렬한, 지독한"
contempt	"경멸, 모욕, 모멸"
feeble	"연약한, 희미한, 나약한"
console	"위로하다, 달래다"
fertile	"기름진, 비옥한, 번식능력이 있는, 풍부한"
vagrant	"방랑자, 방랑하는, 무성한"
flamboyant	"눈부신, 화려한, 현란한"
flourish	"무성하게 자라다, 번창하다"
forestall	"앞서다, 앞지르다, 매점하다, 방해하다"
impolite	"버릇없는, 무례한, 실례되는"
fragrant	"향기로운, 방향성의, 즐거운, 임신한"
fraud	"사기, 기만"
futile	노력이 헛된
improvise	"즉석에서 하다, 임시 대용으로 하다, 즉흥의"
gorgeous	"호화스러운, 화려한, 훌륭한"
grave	"중요한, 심각한, 무덤, 묘, 죽음"
grueling	"녹초로 만드는, 엄한"
incontrovertible	"논쟁의 여지가 없는, 부정할 수 없는, 명백한"
ulcer	"궤양, 병폐, 부패"
hoist	들어 올리다
superlative	"최고의, 최상급의"
extent	"정도, 범위, 구역, 어느 정도로"